    +--------""--+-------+
    |C           |*     C"
    |    |  X            |
    |    +-------    ----+
    "*                   #
    |    +------------   |
    |    |          *    "
    |C           |      C|
    +-"-------##-+---"---+

              S
